1111111111111
10C10000X0001
1011011111101
100E11C01P001
1011000000101
10C1011101101
10000X00010C1
1111111111111